XXXXXXXXXXXXXXXX
XOOOOOOOOOOOOOOX
XOOOOOOOOOOOOOOX
XOOOOOOOOOOOOOOX
XOOOOOOOOOOOOOOX
XOOOOOOOPOOOOOOX
XOOOOOOOOOOOOOOX
XOOOOOOOOOOOOOOX
XOOOOOOOOOOOOOOX
XOOOOOOOOOOOOOOX
XOOOOOOOOOOOOOOX
XXXXXXXXXXXXXXXX