XXXXXXXXXXXXXXXX
XOOOOOOOOOOOOOOX
XOOOOOOOOOOXXXXX
XXXXXOOOOOOOOOOX
XOOOOOOOOOOOOOOX
XOOOOOOOOOOXXXXX
XOOOOOOOOOOOOOOX
XXXXXOOOOOOOOOOX
XOOOOOOOOOOOOOOX
XOOOOOOOOOOXXXXX
XOPOOEOOOOOOOOOX
XXXXXXXXXXXXXXXX