XXXXXXXXXXXXXXXX
XOOOOOOOOOOOOPOX
XOOOOOOOOOOXXXXX
XOOOOOOOOOOOOOOX
XX----XXXX----XX
XOOOOOOOOOOOOOOX
XOOOOOOOOOOOOOOX
XXXXXX----XXXXXX
XOOOOOOOOOOOOOOX
X----XOOOOOOOOOX
EOOOOXOOOOOOOOOX
XXXXXXXXXXXXXXXX