XXXXXXXXXXXXXXXX
XOOOOOOOOOOOOOOE
XOOOOOOOOOOOXXXX
XOOOXXXOOOOOOOOX
XOOOOOOOOOOOOOOX
XOOOOOOOOOOOOOOX
XOOOOOOOOOOOXXXX
XOOOOOOOOOOOOOOX
XOOOXXXOOOOOOOOX
XOOOOOOOOOOOOOOX
XOOOOOOOOOOOOPOX
XXXXXXXXXXXXXXXX