XXXXXXXXXXXXXXXX
XOOOOOOOOOOXOPOX
XOOOOOOOOOOXOXXX
X---XOOOOOOXOOOX
XOOOXOOOOOOXOOOX
XOOOXOOOXXXXOOOX
XOOOXOOOOOOXOOOX
XOOOXOOOKOOOOOOX
XOOOXXXXXXXXXXXX
XOOOOOOOOOOOOXXX
XOOOOOOOOOOOODOE
XXXXXXXXXXXXXXXX