XXXXXXXXXXXXXXXX
XOOOOOOOOOOOOOOE
XOOOOOOOOOOXXXXX
XXXXXOOOOOOOOOOX
XOOOOOOOOOOOOOOX
XOOOOOOOOOOXXXXX
XOOOOOOOOOOOOOOX
XXXXXOOOOOOOOOOX
XOOOOOOOOOOOOOOX
XOOOOOOOOOOXXXXX
XOPOOOOOOOOOOOOX
XXXXXXXXXXXXXXXX