XXXXXXXXXXXXXXXX
XOOOOOOOOOOOOOOX
XOOOBOOKOOOBOOOX
XOOOOXXXXXXOOOOX
XOOOOOOOOOOOOOOX
XXXXOOOOOOOOXXXX
XOOOOOXXXXOOOOOX
XOOOOOOOOOOOOOOX
XOOOOOOOOOOOXXXX
XOOOOOOOOOOOXOOX
XOPOOOOOOOOODOOE
XXXXXXXXXXXXXXXX