XXXXXXXXXXXXXXXXXXXXXXXXXXXX
XOOOOOOOOOOOOOOOOOOOOOOOOOOX
XOOPOOOOOOOOOOOOOOOOOOOOOOOX
XOOOOOOOOOOOBOBOOOOOOOOOOOOX
XOOOOOOOOOOOOOOOOOOOOOOOOOOX
XOOBOBOOOOOOOOOOOOBOBOOOOOOX
XOOOOOOOOOOOOOOOOOOOOOOOOOOX
XOOOOOOOOOOOOOOOOOOOOOOOOOOX
XOOOOOOOOOOOOOOOOOOBOOOOOOOX
XOOOOOOBBBOOOOOOOOOOOOOOOOOX
XOOOOOOOOOOOOKOOOOOOOOOOOOOX
XOOOOOOOOOOOOBOOOOOOOOOOOOOX
XOOOOOBOOOOOOOOOOOOOOOOOOBOX
XOOOOOOOOOOOOOOOOOOOOOOOOOOX
XXXXXXXXXXXXXXXXXXXXXXXXXXXX