XXXXXXXXXXXXXXXXXXXXXXXXXXXX
XOOOOOOOOOOOOOOOOOOOOOOOOOBX
XOOPOOOOOOOOOOOOOOOOOOOOOOOX
XBOOOOOOOOOOOOOOBOOOOOOOOOOX
XXXXXXXXXXXXXXXXXXOOOOOOOOOX
XOOOOOOOOOOOOOOOOOOOOOOOOBOX
XOOOXXXOOOOOOOOOOOOOOOOOOOOX
XOOOXBXOOOOOOOOOOOOOOOOOOOOX
XOOOXXXOOOOOOOOOOOOOOOOOOOOX
XOOOOOOOOOOOOOOOOOOOOOOOOOOX
XOOOOOOOBOOOOOXXXXXXXXXXXXXX
XOOOOOOOOOOOOOXOOOOOOOOOOOOX
XOOOOOOOOOOOOBXOOOOOOOOKOOOX
XOOOOOOOOOOOOOXOOOOOOOOOOOOX
XXXXXXXXXXXXXXXXXXXXXXXXXXXX