XXXXXXXXXXXXXXXXXXXXXXXXXXXX
XOOOOOOOOOOOOOOOOOOOOOOOOOOX
XOOPOOOOOOOOOOOOOOOOOOOOOOOX
XOOXXXXXXXXXXXXXXXXXXXXXXXXX
XOOXOOOOOOOOOOOOOOOOOOOOOOOX
XOOXBOOOOOOOOOOOOOOOOOOOBOOX
XOOXBOOOOOOOBBBOOOOOOOOOBOOX
XOOXOOOOOOOOBKBOOOOOOOOOOOOX
XOOXOOOOOOOOBBBOOOOOOOOOOOOX
XOOXBOOOOOOOOOOOOOOOOOOOBOOX
XOOXBOOOOOOOOOOOOOOOOOOOBOOX
XOOXOOOOOOOOOOOOOOOOOOOOOOOX
XOOXXXXXXXXXXXXXXXXXXXXXXXXX
XOOOOOOOOOOOOOOOOOOOOOOOOOOX
XXXXXXXXXXXXXXXXXXXXXXXXXXXX