XXXXXXXXXXXXXXXX
XOOOOOOOOOOOOOOX
XOOOOOOOOOOOOOOX
XOOOOOOOOOOOOOOX
XOOOOOOOOOOOOOOX
XOOOOOOOOOOOOOOX
XOOOOOOOOOOOOXXX
XOOOOOOBOOKOODOX
XOOOOOOOXXXXXXXX
XOOOOOOOOOOOOOOX
XOPOOOOOOOOOOOOX
XXXXXXXXXXXXXXXX